ለገሮሮህ : ለጉሮሮህ
አቲካራ : ኣተካራ
እንዱሁም : እንዲሁም
መግለፃ : መግለጫ
በዝሮ : በዜሮ
አደለምን : ኣይደለንም
የምታለልለውን : የምታለለውን
አውሁን : አሁን
ሃይለማርም : ሃይለማርያም
ምሐጻረ : ምሕጻረ
ዐረብና : ዐረብኛ
ደርጊት : ድርጊት
ተቀመጡትን : የተቀመጡትን
ሥ : ሥራ
ቃ : ቃል
ቋማቸው : አቋማቸው
ሚሠራ : የሚሠራ
ረሕግ : ሕግ
ሚሠራበት : የሚሠራበት
የሚከተሰውን : የሚከተለውን
ሆነቸው : የሆነችው
የማወላውል : የማያወላውል
ይሠሩበታ : ይሠሩበታል
እንጽፋልን : እንጽፋለን
እነዲሁም : እንዲሁም
ሰዎ : ሰዎች
አማርና : አማርኛ
ስለሚቸወል : ስለሚችል
ሚያውቀ : የሚያውቁ
ጻሓፊዎችን : ጸሓፊዎች
የሚከተሉተን : የሚከተሉትን
ሚል : የሚል
ሆሄትን : ሆሄያትን
በላያ : በላይ
ሚከተሉትን : የሚከተሉትን
ማስያፈልገው : የማያስፈልገው
ላሆኑ : ላይሆኑ
ይመስላኛል : ይመስለኛል
እኒህን : እነዚህን
ደረኩትን : ያደረኩትን
ነበነራቸው : ነበራቸው
አስተዋዪ : አስተዋይ
የመጻ : የመጻፍ
ረእምኑ : እምኑ
ጉዳ : ጉዳይ
የኢትዮጲያ : የኢትዮጵያ
ሰሌካ : ሰባ
ማትም : ማለትም
ምንጽፈው : የምንጽፈው
ያለችግ : ያለችግር
ይው : ይህ
የቀነስ : ይቀነስ
ማት : ማለት
የወክለው : ይወክለው
እንዱሁም : እንዲሁም
ምልቶች : ምልክቶች
እዲሠራባቸው : እንዲሠራባቸው
በተነሠበት : በወሰነበት
ሳምሳሌ : ለምሳሌ
ቄላ : ቆላ
ተብ : ተብሎ
ቄጠረ : ቈጠረ
ተጠሷል : ተጠቅሷል
ቋንቋዎ : ቋንቋዎች
ልሳ : ልሳን
ለማስተማና : ለማስተማርና
ካዳንድ : አንዳንድ
ባመሆኑ : ባለመሆኑ
አቀርባለሀ : አቀርባለሁ
አነዚህ : እነዚህ
አክቭረን : አክብረን
የሎለው : የሌለው
በእንዚህ : በእነዚህ
ስዋሰው : ሰዋሰው
የካሂዷል : ተካሂዷል
ወቶለት : ወጥቶለት
መረዳ : መረጃ
ከሠስት: ከሦስት
በፈት : በፊት
የተጻፊትን : የተጻፉትን
ስው : ሰው
አስተዋዪ : አስተዋይ
ብናበኘው : ብናገኘው
ይለና : ይለናል
በጥኖ : ፈጥኖ
በመጀመሪ : በመጀመሪያ
ከኩሻውያ : ከኩሻውያን
አገሮ : አገሮች
ከዎረቱጋል : ከፖረቱጋል
ቀዋሚ : ቋሚ
ሠርዓት : ሥርዓት
ስለበጀንላቸው : ስላበጀንላቸው
ከኛ : ከእኛ
በሃይኖት : በሃይማኖት
በዐብኛ : በዐረብኛ
ሙብራራት : መብራራት
ውስ : ውስጥ
ባብዛት : በብዛት
ለነሱም : ለእነሱም
ያመጻፍ : ያለመጻፍ
በተሰየወመው : በተሰየመው
እደመግቢያ : እንደመግቢያ
ስሚሠራባቸው : ስለሚሠራባቸው
ማሰገባቱ : ማስገባቱ
በመድበሉ : በመድብሉ
የሚያክተው : የሚያመለክተው
በምሕክቷል : ተመልክቷል
መለት : ማለት
መድበል : መድብል
የሞኪሼ : የሞክሼ
መለትም : ማለትም
የልደፍርም : አልደፍርም
እስገበ : እናስገባ
መጽሐሩ : መጽሐፉ
እደዚህ : እንደዚህ
እንዚህ : እነዚህ
ሌሎቸ : ሌሎቹ
የእሮፓ : የአውሮፓ
ቋንቋቆች : ቋንቋዎች
ሦሻለዝም : ሦሻሊዝም
ሠየኮንዶ : ሤኮንዶ
ሚቶ : ሚስቶ
ኖቴል : ኆቴል
ኖስፒታል : ኆስፒታል
ማድረገ : ማድረግ
የገዕዝ : የግዕዝ
ቃለት : ቃላት
ዐረበኛ : ዐረብኛ
ከእንገሊዝኛ : ከእንግሊዝኛ
ከመጠራጥረና : ከመጠራጠርና
አማርና : አማርኛ
ተሸሽሎ : ተሻሽሎ
ዉስጥ : ውስጥ
መያዛቸዉ : መያዛቸው
ባለፈዉ : ባለፈው
አብረዉ : አብረው
የተገለጸዉ : የተገለጸው
ሶርያዉያን : ሶርያውያን
የሚለዉ : የሚለው
ሳይልካቸዉ : ሳይልካቸው
ሌሎቼ : ሌሎች
ማቀዳቸዉን : ማቀዳቸውን
ተቃርበዉ : ተቃርበው
ዉስጥ : ውስጥ
መክሸፋቸዉን : መክሸፋቸውን
መደናቀፋቸዉን : መደናቀፋቸውን
በጎርጎሪዮሳዊዉ : በጎርጎሪዮሳዊው
አዉሮፕላን : አውሮፕላን
የዋለዉ : የዋለው
ባለፈዉ : ባለፈው
አሳዉቆ : አሳውቆ
በጣጥሰዉ : በጣጥሰው
አልጀርያዉያን : አልጀርያውያን
ተይዘዉ : ተይዘው
ሴራዉ : ሴራው
በሆነችዉ : በሆነችው
የታቀደዉ : የታቀደው
የከተማዉ : የከተማው
የነበረዉ : የነበረው
አራተኛዉ : አራተኛው
ዉስጥ : ውስጥ
የተያዘዉ : የተያዘው
ባለፈዉ : ባለፈው
የዘረዘረዉ : የዘረዘረው
ዉስጥ : ውስጥ
ያለዉ : ያለው
ልዉዉጥ : ልውውጥ
ለመሥራታቸዉ : ለመሥራታቸው
ነዉ : ነው
ዉስጥም : ውስጥም
ያለዉ : ያለው
ልዉዉጥ : ልውውጥ
ነዉ : ነው
ሴራዉን : ሴራውን
የቻለዉ : የቻለው
ዉሳኔ : ውሳኔ
የጠቆመዉ : የጠቆመው
የተፈረጀዉ : የተፈረጀው
አንደኛዉ : አንደኛው
የቆየዉ : የቆየው
ዕቅዳቸዉን : ዕቅዳቸውን
ዉስጥ : ውስጥ
ተቃርበዉ : ተቃርበው
ፌዴራዊው : ፌደራላዊው
አግንተውታል : አግኝተውታል
ብየ : ብዬ
ምክታላቸውን : ምክትላቸውን
አካባቢዋቸው : አካባቢያዊ
ተቃዉሞ : ተቃውሞ
አከባቢዋ : አካባቢዋ
የሆነችዉ : የሆነችው
የተካሄደዉ : የተካሄደው
ተቃዉሞ : ተቃውሞ
በተለምዶዉ : በተለምዶው
ዋላጋ : ወለጋ
በሚጠራዉ : በሚጠራው
አከባቢ : አካባቢ
ጃሞ : ጀሞ
ተቃዉሞ : ተቃውሞ
ዉስጥ : ውስጥ
እንጅ : እንጂ
ስማቸዉ : ስማቸው
የምትገኘዉ : የምትገኝ
በአድስ : በአዲስ
አከባብዉ : አካባቢዋ
ዉጥረት : ውጥረቶች
አከባቢ : አካባቢ
እንድነ : እንደነ
ተናግረዉ : ተናግረው
ዉጥረቶች : ውጥረቶች
ያባባሰዉ : ያባባሰው
በአከባቢዉ : በአካባቢው
ርብሻ : ረብሻ
ዘግተዉ : ዘግተው
በመቶከስ : በመተኮስ
ሱቆቻቸዉን : ሱቆቻቸውን
የሻዬና : የሻይና
ናቸዉ : ናቸው
አከባቢዎች : አካባቢዎች
ደዉዬ  : ደውዬ
እንዳቀጠሉና : እንዳቃጠሉና
እስካ : እስከ
መዘጋታቸዉን : መዘጋታቸውን
በወሰደዉ : በወሰደው
አለመኖራቸዉ : አለመኖራቸውን
ተጭነዉ : ተጭነው
መወሰዳቸዉንና : መወሰዳቸውንና
ስያወጡ : ሲያወጡ
አይቻለዉ : አይቻለው
ተሰብስበዉ : ተሰብስበው
አስፈራርተዉ : አስፈራርተው
እንደሚበትኗቸዉም : እንደሚበትኗቸውም
ለማገኘት : ለማግኘት
ያደረግነዉ : ያደረግነው
እንጅ : እንጂ
የአገርቱን : የአገሪቱን
እንደዘገበዉ : እንደዘገበው
የሚያድንቁትና : የሚያደንቁትና
እየተናነቃ : እየተናነቃቸው
እንጀ : እንጂ
ቀልስስ : ቀስ
ባትችዋ : ለናቶችዋ
በጊሊትና : በጉሊትና
ማናባቴን : ምናባቴ
የማባለው : የሚባለው
ፈትሽ : ፊትሽ
ይፋለጋል : ይፈለጋል
የማችል : የማይችል
የሚለጣጥ : የሚለግጥ
በክርነ : በክርኑ
የውም : ያውም
በማጨረት : ለማጫረት
ከፍትኛ : ከፍተኛ
የነበርውን : የነበረውን
ባደረገዉ : ባደረገው
ዉድቀት : ውድቀት
ያለዉ : ያለው
በዉይይቱ : በውይይቱ
ቀርበዉ : ቀርበው
ቃላቸዉን : ቃላቸውን
በስብሰባዉ : በስብሰባው
የመቀረት : የመቅረት
ክልልሎች : ክልሎች
የእንሳት : የእንስሳት
ፈርማሲ : ፋርማሲ
ውጥቶ : ወጥቶ