legeroroh : leguroroh
^etikara : ^atekara
^nduhum : ^ndihum
megle^Sa : megleCa
bezro : bezEro
^edelemn : ^aydelenm
yemtalellewn : yemtalelewn
^ewhun : ^ehun
haylemarm : haylemaryam
mHeSare : mHSare
`erebna : `erebNa
dergit : drgit
teqemeTutn : yeteqemeTutn
^s : ^sra
qa : qal
qWamacew : ^eqWamacew
mi^sera : yemi^sera
reHg : Hg
mi^serabet : yemi^serabet
yemiketesewn : yemiketelewn
honecew : yehonecw
yemawelawl : yemayawelawl
y^serubeta : y^serubetal
^nSfaln : ^nSfalen
^nedihum : ^ndihum
sewo : sewoc
^emarna : ^emarNa
slemicewel : slemicl
miyawqe : yemiyawqu
SaHafiwocn : SeHafiwoc
yemiketeluten : yemiketelutn
mil : yemil
hohEtn : hohEyatn
belaya : belay
miketelutn : yemiketelutn
masyafelgew : yemayasfelgew
lahonu : layhonu
ymeslaNal : ymesleNal
^nihn : ^nezihn
derekutn : yaderekutn
nebeneracew : neberacew
^estewayi : ^esteway
yemeSa : yemeSaf
re^mnu : ^mnu
guda : guday
ye^ityoPiya : ye^ityoPya
selEka : seba
matm : maletm
mnSfew : yemnSfew
yalecg : yalecgr
yw : yh
yeqenes : yqenes
mat : malet
yeweklew : yweklew
^nduhum : ^ndihum
mltoc : mlktoc
^di^serabacew : ^ndi^serabacew
betene^sebet : bewesenebet
samsalE : lemsalE
qEla : qola
teb : teblo
qETere : qWeTere
teTesWal : teTeqsWal
qWanqWawo : qWanqWawoc
lsa : lsan
lemastemana : lemastemarna
kadand : ^endand
bamehonu : balemehonu
^eqerbalehe : ^eqerbalehu
^enezih : ^nezih
^ekvren : ^ekbren
yelolew : yelElew
be^nzih : be^nezih
swasew : sewasew
yekahidWal : tekahidWal
wetolet : weTtolet
mereda : mereja
ke^sest: ke^sost
befet : befit
yeteSafitn : yeteSafutn
sw : sew
^estewayi : ^esteway
bnabeNew : bnageNew
ylena : ylenal
beTno : feTno
bemejemeri : bemejemeriya
kekuxawya : kekuxawyan
^egero : ^egeroc
keworetugal : keporetugal
qewami : qWami
^ser`at : ^sr`at
slebejenlacew : slabejenlacew
keNa : ke^Na
behaynot : behaymanot
be`ebNa : be`erebNa
mubrarat : mebrarat
ws : wsT
babzat : bebzat
lenesum : le^nesum
yameSaf : yalemeSaf
beteseyewemew : beteseyemew
^demegbiya : ^ndemegbiya
smi^serabacew : slemi^serabacew
masegebatu : masgebatu
bemedbelu : bemedblu
yemiyaktew : yemiyamelektew
bemHktWal : temelktWal
melet : malet
medbel : medbl
yemokixE : yemokxE
meletm : maletm
yeldefrm : ^eldefrm
^sgebe : ^nasgeba
meSHeru : meSHefu
^dezih : ^ndezih
^nzih : ^nezih
lEloce : lElocu
ye^ropa : ye^ewropa
qWanqWaqoc : qWanqWawoc
^soxalezm : ^soxalizm
^seyekondo : ^sEkondo
mito : misto
notEl : ^hotEl
nospital : ^hospital
madrege : madreg
yege`z : yeg`z
qalet : qalat
`erebeNa : `erebNa
ke^ngelizNa : ke^nglizNa
kemeTeraTrena : kemeTeraTerna
^emarna : ^emarNa
texexlo : texaxlo
wusT : wsT
meyazacewu : meyazacew
balefewu : balefew
^ebrewu : ^ebrew
yetegeleSewu : yetegeleSew
soryawuyan : soryawyan
yemilewu : yemilew
saylkacewu : saylkacew
lElocE : lEloc
maqedacewun : maqedacewn
teqarbewu : teqarbew
wusT : wsT
mekxefacewun : mekxefacewn
medenaqefacewun : medenaqefacewn
begorgoriyosawiwu : begorgoriyosawiw
^ewuroplan : ^ewroplan
yewalewu : yewalew
balefewu : balefew
^esawuqo : ^esawqo
beTaTsewu : beTaTsew
^eljeryawuyan : ^eljeryawyan
teyzewu : teyzew
sErawu : sEraw
behonecwu : behonecw
yetaqedewu : yetaqedew
yeketemawu : yeketemaw
yeneberewu : yeneberew
^erateNawu : ^erateNaw
wusT : wsT
yeteyazewu : yeteyazew
balefewu : balefew
yezerezerewu : yezerezerew
wusT : wsT
yalewu : yalew
lwuwuT : lwwT
leme^sratacewu : leme^sratacew
newu : new
wusTm : wsTm
yalewu : yalew
lwuwuT : lwwT
newu : new
sErawun : sErawn
yecalewu : yecalew
wusanE : wsanE
yeTeqomewu : yeTeqomew
yeteferejewu : yeteferejew
^endeNawu : ^endeNaw
yeqoyewu : yeqoyew
`qdacewun : `qdacewn
wusT : wsT
teqarbewu : teqarbew
fEdErawiw : fEderalawiw
^egntewtal : ^egNtewtal
bye : byE
mktalacewn : mktlacewn
^ekababiwacew : ^ekababiyawi
teqawumo : teqawmo
^ekebabiwa : ^ekababiwa
yehonecwu : yehonecw
yetekahEdewu : yetekahEdew
teqawumo : teqawmo
betelemdowu : betelemdow
walaga : welega
bemiTerawu : bemiTeraw
^ekebabi : ^ekababi
jamo : jemo
teqawumo : teqawmo
wusT : wsT
^nj : ^nji
smacewu : smacew
yemtgeNewu : yemtgeN
be^eds : be^edis
^ekebabwu : ^ekababiwa
wuTret : wTretoc
^ekebabi : ^ekababi
^ndne : ^ndene
tenagrewu : tenagrew
wuTretoc : wTretoc
yababasewu : yababasew
be^ekebabiwu : be^ekababiw
rbxa : rebxa
zegtewu : zegtew
bemetokes : bemetekos
suqocacewun : suqocacewn
yexayEna : yexayna
nacewu : nacew
^ekebabiwoc : ^ekababiwoc
dewuyE  : dewyE
^ndaqeTeluna : ^ndaqaTeluna
^ska : ^ske
mezegatacewun : mezegatacewn
bewesedewu : bewesedew
^elemenoracewu : ^elemenoracewn
teCnewu : teCnew
mewesedacewunna : mewesedacewnna
syaweTu : siyaweTu
^eycalewu : ^eycalew
tesebsbewu : tesebsbew
^esferartewu : ^esferartew
^ndemibetnWacewum : ^ndemibetnWacewm
lemageNet : lemagNet
yaderegnewu : yaderegnew
^nj : ^nji
ye^egertun : ye^egeritun
^ndezegebewu : ^ndezegebew
yemiyadnqutna : yemiyadenqutna
^yetenaneqa : ^yetenaneqacew
^nje : ^nji
qelss : qes
batcwa : lenatocwa
begilitna : begulitna
manabatEn : mnabatE
yemabalew : yemibalew
fetx : fitx
yfalegal : yfelegal
yemacl : yemaycl
yemileTaT : yemilegT
bekrne : bekrnu
yewm : yawm
bemaCeret : lemaCaret
keftNa : kefteNa
yeneberwn : yeneberewn
baderegewu : baderegew
wudqet : wdqet
yalewu : yalew
bewuyytu : bewyytu
qerbewu : qerbew
qalacewun : qalacewn
besbsebawu : besbsebaw
yemeqeret : yemeqret
kllloc : klloc
ye^nsat : ye^nssat
fermasi : farmasi
wTto : weTto